0000000000000000
0000000000000000
0000000000000000
0000000000000000
0000000000222222
0000000002222222
0000000000002222
0000000000022222
0000000002200222
0000000222222222
0000222222222222
0000222222222222
0000000222222222